##########
#S...#...#
#.##.#.#.#
#.#..#.#.#
#.#.##.#.#
#...#...E#
##########